comments{
Test map for rendering - 8x16 rectangular map
}
info{
rowcount:8
colcount:16
levelname:Rectangle Test
biome:rock
creator:Test
}
tiles{
38,38,38,38,38,38,38,38,38,38,38,38,38,38,38,38,
38,1,1,1,1,1,1,1,1,1,1,1,1,1,1,38,
38,1,42,42,1,1,1,1,1,1,1,1,42,42,1,38,
38,1,42,42,1,1,1,1,1,1,1,1,42,42,1,38,
38,1,1,1,1,1,1,1,1,1,1,1,1,1,1,38,
38,1,1,1,1,1,1,1,1,1,1,1,1,1,1,38,
38,1,1,1,1,1,1,1,1,1,1,1,1,1,1,38,
38,38,38,38,38,38,38,38,38,38,38,38,38,38,38,38,
}
height{
0,0,0,0,0,0,0,0,0,0,0,0,0,0,0,0,0,
0,100,100,100,100,100,100,100,100,100,100,100,100,100,100,100,0,
0,100,150,150,100,100,100,100,100,100,100,100,150,150,100,100,0,
0,100,150,150,100,100,100,100,100,100,100,100,150,150,100,100,0,
0,100,100,100,100,100,100,100,100,100,100,100,100,100,100,100,0,
0,100,100,100,100,100,100,100,100,100,100,100,100,100,100,100,0,
0,100,100,100,100,100,100,100,100,100,100,100,100,100,100,100,0,
0,100,100,100,100,100,100,100,100,100,100,100,100,100,100,100,0,
0,0,0,0,0,0,0,0,0,0,0,0,0,0,0,0,0,
}
resources{
crystals:
0,0,0,0,0,0,0,0,0,0,0,0,0,0,0,0,
0,0,0,0,0,0,0,0,0,0,0,0,0,0,0,0,
0,0,5,5,0,0,0,0,0,0,0,0,5,5,0,0,
0,0,5,5,0,0,0,0,0,0,0,0,5,5,0,0,
0,0,0,0,0,0,0,0,0,0,0,0,0,0,0,0,
0,0,0,0,0,0,0,0,0,0,0,0,0,0,0,0,
0,0,0,0,0,0,0,0,0,0,0,0,0,0,0,0,
0,0,0,0,0,0,0,0,0,0,0,0,0,0,0,0,
ore:
0,0,0,0,0,0,0,0,0,0,0,0,0,0,0,0,
0,0,0,0,0,0,0,0,0,0,0,0,0,0,0,0,
0,0,0,0,0,0,0,0,0,0,0,0,0,0,0,0,
0,0,0,0,0,0,0,0,0,0,0,0,0,0,0,0,
0,0,0,0,0,0,0,0,0,0,0,0,0,0,0,0,
0,0,0,0,0,0,0,0,0,0,0,0,0,0,0,0,
0,0,0,0,0,0,0,0,0,0,0,0,0,0,0,0,
0,0,0,0,0,0,0,0,0,0,0,0,0,0,0,0,
}
objectives{
resources: 20,0,0
}
buildings{
BuildingToolStore_C,Translation: X=450.000 Y=450.000 Z=100.000 Rotation: P=0.000000 Y=0.000000 R=0.000000 Scale X=1.000 Y=1.000 Z=1.000
}